b b b b b b b b b r r r r r r r b t b b t b b b e 4 b 
e r r r r a a t b r b b b b r r b r b b r b 3 b e b b 
e b b b b b r b b r b b r b r b b r r r r b g b r r b 
r r r r t b r r r r r b r b r r r r b r e b b b b r b 
r b b r b b r b b b r b r r r r b r a b e a a b r e b 
r b e e r r r b b b r b r b b b r r b a r b b h r h b 
r b r b r b r r r r r r r r e e r h h b r b b b r r b 
3 b h b r b r b r b b r b r b b r b b b r b h r r b b 
a a a b h r r b r b b r b r a a r r r r r r r b r t b 
b b b b b b b r e e e e b b b b b b b a a b b b h b b 
b t b h a b b r b b b r b r r r b 1 b b r a a b r r b 
b r r h b a b r b 0 r r r r b r r r b r r b r b b r b 
b r b b b a b r b r b b b b b b b r r h b b r b r a b 
b e e r b t a r b r r r r r e t b r b r r b e b e a b 
b r b r b b r b b b b b b t e b b r b b r b e b e r b 
b r b r b t r b b b b b b b b b b r b r r b e b r b b 
b r b e b b e b r 2 b r r r t b b b b r b b e b r b a 
b b h e r r r h b a b r b b b b r 0 b r b h r b r b a 
b a r b r b b b b h b r b s r r r b b r b b r b r r r 
b a b b r b b b b a b r b b b r b h r r r r r b e b b 
b r b r h r b a b a b r e 1 b r b h b b r b r b r t b 
b r b r b r b a b b b r b b b r b e b r r b r b r b b 
b r a a b h r r r r r r r b r r b e b r b b r b r r r 
b b b b b r b b b r b b b b r b b r b r b b r b e b r 
b r r r r r r r b h h r r r r b r r b b b e r b e b e 
b b b r b h b r b r r b r r r b r b r 2 b e b b r b e 
b r r r a b a e a b r b r r r r r r r b b e b b r e e 
b b r b r r r r b a a b b b r r b b r r r r r b b b b 
b b r r r b r r r e b b b b b r b b b b b b r b b 4 b 
b b b b r r r r r r r r r r r r r e e e t b r b b t b 
b b b b b b b b b b b b b b b b b b b b b b b b b b b 
