b s b b b b b b b b b b b b b b b b b b b b b b b b b b b b b b b b b b b b b b b b b b b b b b b 
b r b r r r r r r r r r r r r r r r r r r r r r r r r r r r r r r r r r r r r r r r r r r r r r b
b r b r b b b b b b b b b b r b r b b b r b b b b r b b b r b b b b b b b b b b b b b b b b b r b
b r b r b r r r r r r r b b r b r r r r r r r r r r r r r r r r r r r r r r r r r r r r r r r r b 
b r b r b r b r b b b r b b r b r b b b b b b b b b b b b b b b b b b b b b b b b b b b b b b r b
b r r r r r b r b r b r b b r b r r r r r r r r r r r b r r r r r r r r r r r r r r r r r r r r b
b b b b b b b r b r b r b b r b b b b b b b b b b b b b r b b b b b b b r b b b b b b b b b b r b
b h b b b b b r b r b r b b r b r r e e e e e e e h b r b r r r r r b r b r r r r r r r r b r b b
b r b b b b b r b r b r b b r b r b b b b b b b b b b b r b r b b b r b r r b b b b b b b r b r b 
b r b b b b b r b r r r b b r b r a a a a a a a a a a b r b r b r b r b r b r r r r r r r r b r b
b r r r r r r r b b b b b b r b r b b b b b b b b b b b r b r b r b r b r b r b b b b b b b b r b
b r b b b b b b b b b b b b r b r r r r r r r r r r r r r b r b r b r b r b r r r r r r r r b r b
b r r r r r r r r r r r r b r b b b b b b b b b b b b b b b r b r b r b r b b b b b b b b r b r b
b r b b b b b b b b b b r b r r r r r r r r r r r r r r r r r b r b r b r b r r r r r r b r b r b
b b b b b b b b b b b b r b b b b b b b b b b b b b b b b b b b r b r b r b r b b b b r b r b r b
b r r r r r r r r r r r r r r r r r r r r r r r r r r r r r r r r b r b r b r b b b b r r r b r b
b r b b b b b b b b b b b b b b b b b b b b b b b b b b b b b b b b r b r b r b b b b b b b b r b
b r r r r r r r r r r r r r r r r r r r r r r r r r r r r r r r r r r b r b r r r r r r r r b r b
b r b b b b b b b b b b b b b b b b b b b b b b b b b b b b b b b b b b r b b b b b r b b r b r b
b r r r r r r r r r r r r r r r r r r r r r r r r r r r r r r r r r r r r b r r r r r r r r r r b
b r b b b b b b b b b b b b b b b b b b b b b b b b b b b b b b b b b b b b b b b b b b b b b b b
b r r r r r r r r r r r r r r r r r r r r r r r r r r r r r r r r r r r r r r r r r r r r r r r b
b b b b b b b b b b b b b b b b b b b b b b b b b b b b b b b b b b b b b b b b b r b b r b b r b
b r r r r r r r r r r r r r r r r r r r r r r r r r r r r r r r r r r r r r r r r r b b r b b r b 
b a b b b b b b b b b b b b b b b b b b b b b b b b b b b b b b b b b b b b b b b b b b r b b r b
b t r r r r a a a a r r r a a a a r r r a a a a r r r a a a a r r r a a a a r r r a a a a b b r b
b a b b b b b b b b b b b b b b b b b b b b b b b b b b b b b b b b b b b b b b b b b b b b b r b
b r r r r r r e e e e r r r e e e e r r r e e e e r r r e e e e r r r r e e e e r r r e e e e r b
b r b b b b b b b b b b b b b b b b b b b b b b b b b b b b b b b b b b b b b b b b b b b b b b b
b r b r r r b r r r b r r r b b b b b b b b b b b r r r r r r r r r r r r r r r r r r r r r r r b 
b r b r b r b r b r b r b r b r r r r r r r r h b r b b b b b b b b b b b b b b b b b b b b b 2 b
b r b r b r b r b r b r b r b r b b b b b b b b b r b r r r r r r r r r r r r r r r r r r r b b b
b r r r b r r r b r r r b r b r r r r r r r r r r r b r b r b r b b b b b b b b b b b b b r r r b
b b b b b b b b b b b b b r b b b b b b b b b b b r b r b r b r r r r r r r r r r r r r r b b r b
b a r r r r r r r r r r r r r r r r r r r r r r r r r r b r b r b b b b b b b b b b b b b b b r b
b 1 b b b b b b b b b b b b b b b b b b b b b b b b b b b r b r b b b b b b b b b b b b b r b r b 
b b b h r r r r r r r r r r r r r r r r r r r r r r r r r r b r r r r r r r r r r r r r r r b r b
b b b b b b b b b b b b b b b b b b b b b b b b b b b b b b b b b b b b b b b b b b b b b b b r b
b r r r r r r r r r r r r r r r r r r r r b r r r r r r r r r r r r r r r r r r r r r r r r r r b
b b b r b b r b b r b b r b b b b b b b r b r b b b b b b b b b b b b b b b b b b b b b b b b b b
b h b r b b e b b a b b t b b b b b b b r b r r r r r r r r r r r r r r r r r r r r r r r r r r b
b t b r b b e b b a b b r b b b b b r r r b b b b b b b b b b b b b b r b b b r b b b r b b b r b
b r b r b b e b b a b b r b b b b b r b b b b r r r r r r r r r r 2 b r b b b r b 1 b r b r e r b
b r b r b b e b b a b b r b b b b b r r r r b r b b b b b b b b b b b r b b b r b r b r b r b r b
b r b r b b e b b a b b r b b b b b b b b r b r r r r r r r r r r r r r b b b r r r b r b r b r b
b r b r b b e b b a b b r b b b b r r r b r b b b b b b b b b b b b b b b b b b b b b r b r b r b
b r b r b b e b b a b b r b b b b r b r b r r r r r r r r r r r r r r r r r r r r r r r r r b r b
b r b r b b e b b a b b r b b b b r b r b b b b b b b b b b b b b b b b b b b b b b b b b r b r b
b r r r b t r r r r r r h b b b b r b r r r r r r r r r r r r r r r r r r r r r r r r r r r b r b
b b b b b b b b b b b b b b b b b g b b b b b b b b b b b b b b b b b b b b b b b b b b b b b b b