e e b s b b b b r r r r r r r e b b b r r r b a b r r r r r r r r r r r r r r
r b b r r e e e b b e b a r b a h a b r b r r r r r b b r a b b b b b b b b r
r e e r b s r r r r r r r r r b b b b r b t b r r r r r r b a b t r r r r r r
r b b r b b b r b b r b b e e b b b b r b b e b b a a a b b a b b r b r b b b
r b a r b b b r b h r b b r r e e e r r a b e r r b r b e e a b b r b b b b b
r b b r r r r r r r r b b r r r r r b b r r r r h b h a h b b b b r r r a a a
r a b b e b b a b b b b b r r b r r b r r a b b r b b b b b b b b b r b b b b
r r r b e b b a b r r r r r r b b b b r r a a a b b b r r r r r r r r e e b b
b b r b b b b b b r b b b b e r r r r b b b b b b b r r b b b h b b b b b b b
b e r r b t r r r e e r r r r b b b r r r r r r r r r b r r r r r r r r r b b
a r b r b b b r b b b b b b r b t b b b b b r b b b b b e b a b b b b b r b b
a r r r e r r r r r r r r b r b e b b b b r r r r r r e e b r r r r b t b b b
b b b r b b r b r b b b r r r b e r r r r r b b b r r r r b b b b r e e e r g
b b b r h b r r r r h b b b b b b b b b b b b b b b b b r r r r b b b b t b b
r r r r b b b b b r b b a b b b b t b b b b h b b b b b r b b r b b b b b b b
b b b r r r a e a b b b b b r e e e r h r r r r e e e r r r r r e e a a a b b
b b b b r b b b b b a e a e h b b r a r e e r e e b b b b b b b h b b b r a a
r r r r r b b b b t b b b b b b b b r b b b b b b b b r r r h b b b b b r b b
r b b b b b h h r r e r r e r r r r r r e e e e b b b r b b r e e r e r r a t
r b r b r b b b b b b b b b r b b b b b h b b r r r r r b b b b b b b b b e b
r b r b e r r e r r r b r r r r r r r r r a a a b b b b r r r r r r r r r r r
e b r r r b b b b b r r r b b b b b r b b b b b b r r r r b r b b b b r b b b
r b r b r r r r r r h b r b a a a a r r r r r r b b b b r r r r r r r r r r r
e r r b r b b b b b r r r b b b r b b b b b b r r r r r r r b b b b b b b b r
r b r e e h h a a b r a r r r r r r r r r r r r r b b r b r r r r r e e e e r
r b a b r b b b r e e r r b r b b b b b b b b b r b b r b b b b b b r b b b h
r r a b r r e e r b b b r b b b b r e e h r r r r r b r b b b b b b r b b r r
r b b b r b b h b b b b r b h h b b b b r b b b h r b r b b b b b b h b b r b
r r r r r b b r r e e r r b b r b r r a r b b b b r b b b b b b r r r r e r b
b b b b b b b t b b b b e e r r r r b b b b e e e r r r r r r r a b b b b t b 




