b h r e e e r r r r 3 b h r e e r r r 2 
b r r b b b b b b b b b r b b b b b b b 
b r h e e t b t r r b b 3 b r r r r r b 
b r b b b b b b r a a b b b r b b r b b 
b r b e e e r b r r e e r b r b a r h b 
b r b e b b r b r b b b r b e b b r b b 
b g b r r b r b h b s r r b e b b r t b 
b b b b r b 0 b r b b b r b r b b r b b 
b b h b r b b b r a b b e b r b b r h b 
b r r r r r b 0 r h b e e b 1 b b r b b 
b b r b b e b b b b b e b b b b b r b b 
b b r e b e e r r b r r b 1 r h b r 2 b 
b t b e b b b b t b r b b b b r b r b b 
b h r r r a a b b b a a r h h r b r a b 
b b b b b b b b r b b b b b b b b b b b 
r r r r r r r r r r r r r r r r r r r r 
r r r r r r r r r r r r r r r r r r r r 
r r r r r r r r r r r r r r r r r r r r 
r r r r r r r r r r r r r r r r r r r r 
