b a r r h r a r r r r r h r e e e r r r 
r r b t b b b b b b b b b b b b b b b a 
h b b b b r r r b r r r r r b t b 2 b r 
r b 1 r h r b e b r b a b r r h b r b r 
a b b b b b b e b r b b b b r b b r b h 
r b r r r r e e b r b e e e r r r r b e 
e b r b b b b b b r b t b r b r b h b e 
r b r b r h r b r h b b b r b r b a b e 
h b e r r b a b r b b r r r r r b a b e 
e b b b b b a b h b e e b b r b b b b r 
r b r a r r r b r b b e b r r b r 0 b r 
r b t b b b r e e b e e b r b b r b b r 
a b b b h b b b b b b b b r b b e b a r 
a b e e e e e b a b a h b 3 b b e b b r 
r b b b b r b b h b h b b b b b e 1 b r 
r b b 2 b a a b e b e b r b 3 b b b b r 
e 0 b g b r r r r r r r r r e e a h b r 
r b b b b b b b b b b b b b b b b b b r 
h r r e e e e e r r a r r r r r r r r s 
